French TreeTagger Part-of-Speech Tags

Achim Stein, April 2003

ABR	abreviation
ADJ	adjective
ADV	adverb
DET:ART	article
DET:POS	possessive pronoun (ma, ta, ...)
INT	interjection
KON	conjunction
NAM	proper name
NOM	noun
NUM	numeral
PRO	pronoun
PRO:DEM	demonstrative pronoun
PRO:IND	indefinite pronoun
PRO:PER	personal pronoun
PRO:POS	possessive pronoun (mien, tien, ...)
PRO:REL	relative pronoun
PRP	preposition
PRP:det	preposition plus article (au,du,aux,des)
PUN	punctuation
PUN:cit	punctuation citation
SENT	sentence tag
SYM	symbol
VER:cond	verb conditional
VER:futu	verb futur
VER:impe	verb imperative
VER:impf	verb imperfect
VER:infi	verb infinitive
VER:pper	verb past participle
VER:ppre	verb present participle
VER:pres	verb present
VER:simp	verb simple past
VER:subi	verb subjunctive imperfect
VER:subp	verb subjunctive present